R 600 800

NO ./includes/textures/north.xpm

SO ./includes/textures/south.xpm

WE ./includes/textures/west.xpm

EA ./includes/textures/east.xpm

S ./includes/textures/sprite.xpm

F 220,100,0

C 225,30,0

111111111111111
100000002000001
10000200000S001
100000002000001
100011111110001
100011000110001
111111111110001
         100011111111111
         100011000110001
         100011000110001
         100011111110001
         100000000000001
         100020000020001
         100000000000001
         100020000020001
         100000000000001
         111111111111111
