R 800 800

NO ./includes/textures/north.xpm

SO ./includes/textures/south.xpm

WE ./includes/textures/west.xpm

EA ./includes/textures/east.xpm

S ./includes/textures/sprite.xpm

F 220,100,100

C 122,122,254

111111111111111
100000100000001
100000100W00001
100000100000001
110000100000001
110000111111111
100000000000001
100011100000100
10001 100000001
100011100000001
100000000000001
100022222220000
100022222220000
100022222220000
100022222220001
100022222221111
111111111111111