R 800 800

NO ./includes/textures/north.xpm

SO ./includes/textures/south.xpm

WE ./includes/textures/west.xpm

EA ./includes/textures/east.xpm

S ./includes/textures/sprite.xpm

F 220,100,100

C 122,122,254

111111111111111
100100002000001
1S0102000000011
100000002000001
100111111110001
100111000110001
111111111110001
100011000010011
100011000110001
100011000110001
100011000110001
100000000000001
100020000020001
100000000000001
100020000020001
100020000020001
111111111111111